9 10
|========|
|==####==|
|==#XX#==|
|=## X##=|
|=#  OX#=|
|## O  ##|
|#  #OO #|
|#  @   #|
|########|
||=======|
