9 13
|===========|
|===######==|
|===# XXX#==|
|####XXXX#==|
|#  ###O ###|
|# O O  OO #|
|#@ O O    #|
|#   ###   #|
|#####=#####|
||==========|
