14 18
|================|
|====####========|
|#####  #========|
|#  O O #=#######|
|#   O  #=#QXQXQ#|
|## O O ###XQXQX#|
|=#O O  #  QXQXQ#|
|=#@O O    XQXQX#|
|=#O O  #  QXQXQ#|
|## O O ###XQXQX#|
|#   O  #=#QXQXQ#|
|#  O O #=#######|
|#####  #========|
|====####========|
||===============|
