9 11
|=========|
|===######|
|####X  @#|
|#  OOO  #|
|#X##X##X#|
|#   O   #|
|#  OX# ##|
|####   #=|
|===#####=|
||========|
