9 8
|======|
|=####=|
|##  #=|
|#@O #=|
|##O ##|
|## O #|
|#XO  #|
|#XXQX#|
|######|
||=====|
