9 10
|========|
|=#####==|
|=# @###=|
|=# O  #=|
|### # ##|
|#X# #  #|
|#XO  # #|
|#X   O #|
|########|
||=======|
