8 10
|========|
|########|
|#  #   #|
|# OXXO #|
|#@OXQ ##|
|# OXXO #|
|#  #   #|
|########|
||=======|
