9 12
|==========|
|=#######==|
|=#XXXX #==|
|###XXXO###|
|#  O#O O #|
|# OO  #O #|
|#    #   #|
|#### @ ###|
|===#####==|
||=========|
