9 12
|==========|
|==#####===|
|###   ####|
|#   O  O #|
|# O @O   #|
|###OO#####|
|==#  XX#==|
|==#XXXX#==|
|==######==|
||=========|
