11 13
|===========|
|=====######|
|=#####X   #|
|=#  #XX## #|
|=#  OXX   #|
|=#  # X# ##|
|### ##O#  #|
|# O    OO #|
|# #O#  #  #|
|#@  #######|
|#####======|
||==========|
