8 11
|=========|
|########=|
|#XXXXXX#=|
|#  O # ##|
|# O # O #|
|##O O O #|
|=#  @   #|
|=########|
||========|
