11 12
|==========|
|#########=|
|#   ##  #=|
|# # O O #=|
|#  QX#  #=|
|## #X@X##=|
|##O###Q###|
|#        #|
|#   ## # #|
|######   #|
|=====#####|
||=========|
