10 13
|===========|
|=#########=|
|=#  ##   #=|
|=#   O   #=|
|=#O ### O#=|
|=# #XXX# #=|
|## #XXX# ##|
|# O  O  O #|
|#     #  @#|
|###########|
||==========|
