7 14
|============|
|=####==#####|
|##  #==#   #|
|# O ####O  #|
|#  OXXXX O #|
|##    # @ ##|
|=##########=|
||===========|
