8 10
|========|
|=######=|
|##    ##|
|# O OO #|
|#XXXXXX#|
|# OO O #|
|### @###|
|==####==|
||=======|
