10 12
|==========|
|==########|
|==#    ###|
|==# O    #|
|### O ## #|
|#XXX O   #|
|#XXXO#O ##|
|#### # O #|
|===#   @ #|
|===#######|
||=========|
