8 11
|=========|
|######===|
|#    #===|
|# OOO##==|
|#  #XX###|
|##  XXO #|
|=#  @   #|
|=########|
||========|
