9 9
|=======|
|#######|
|#XXOXX#|
|#XX#XX#|
|# OOO #|
|#  O  #|
|# OOO #|
|#  #@ #|
|#######|
||======|
