13 17
|===============|
|======#########|
|======#       #|
|======# # # # #|
|======#  O O# #|
|#######   O   #|
|#XX#  ## O O# #|
|#XX   ## O O  #|
|#XX#  ## ######|
|#XX# # O O #===|
|#XX     O  #===|
|#  ###@  ###===|
|####=#####=====|
||==============|
